%%%%%%%%%%%%%
%G..........%
%.%%.%.%.%%.%
%...........%
%.%%.%.%.%%P%
%...........%
%%%%%%%%%%%%%
