%%%%%%%%%%%%%%%%%%%%
%G...%...%%...%...G%
%.%%.%.%%%%%%.%.%%.%
%.%..............%.%
%.%.%%.%%..%%.%%.%.%
%..................%
%.%%%%%%%%%%%%%%%..%
%..................%
%.%.%%.%%..%%.%%.%.%
%.%..............%.%
%.%%.%.%%%%%%.%.%%.%
%G...%...%%...%...P%
%%%%%%%%%%%%%%%%%%%%
