%%%%%%%%%%%%%%%%%%%%
%G...%........%...G%
%.%%.%.%%%%%%.%.%%.%
%.%..............%.%
%.%.%%.%%  %%.%%.%.%
%......   P  ......%
%.%.%%.%%  %%.%%.%.%
%.%..............%.%
%.%%.%.%%%%%%.%.%%.%
%....%........%...o%
%%%%%%%%%%%%%%%%%%%%